0 3 1 2 0 0 0 7 9
5 4 0 0 0 9 1 0 0
8 0 0 0 0 7 0 0 5
2 6 8 0 0 1 5 0 0
1 0 0 0 0 0 0 0 8
0 0 9 4 0 0 7 1 6
9 0 0 8 0 0 0 0 2
0 0 3 5 0 0 0 6 7
7 2 0 0 0 4 3 8 0